################
#      @    #  #
#           #XX#
#           #  #
#              #
#              #
#              #
#              #
#              #
#              #
#              #
#              #
#              #
#              #
#              #
################
