################
#       @   #  #
#           #XX#
#      d    #  #
#              #
#    L       V #
#              #
#    d O  d    #
#   d          #
#  d     G     #
#              #
#              #
#   d          #
#              #
#    #         #
################
